22222N22222
25555555552
25552525552
25552525552
255!2222252
2555222555E
25552222252
25552525552
25552525552
25555555552
22222S22222