22222N22222
25555555552
25555555552
25555555552
25555555552
W5555555552
25555555552
25555555552
25555555552
25555555552
22222222222