22222222222
25555555552
25555555552
25555555552
25555555552
W5555555552
25555555552
25555555552
25555555552
25555555552
22222S22222