22222222222
25555555552
25555555552
25525552552
25552225552
W555252555E
25552225552
25525552552
25555555552
25555555552
22222S22222