22222N22222
25555555552
25555555552
25555555552
25555555552
W555555555E
25555555552
25555555552
25555555552
25555555552
22222S22222