22222N22222
25555525552
25555255552
25552555552
22555552552
W525555525E
25525555522
25555555552
25555555552
25555555552
22222222222