22222N22222
25555555552
25525555552
25525555252
25525555522
2552552555E
25525555522
25525555252
25525555552
25555555552
22222S22222