33333N33333
36666666663
36366366363
36666666663
36666366663
W636363636E
36666366663
36666666663
36366366363
36666666663
33333S33333