33333N33333
36666666663
36666666663
36666666663
36666666663
W6666666663
36666666663
36666666663
36666666663
36666666663
33333S33333