33333N33333
36666666663
36666666663
36666666663
36666666663
3666666666E
36666666663
36666666663
36666666663
36666666663
33333S33333