33333N33333
36666666663
36663333333
36636666663
36636666363
3666366636E
36663666633
36666336663
36666666663
36366666663
33333333333