33333333333
33666666633
36366666363
36663636663
36633633663
W6666666663
36633633663
36663636663
36366666363
33666666633
33333S33333