33333N33333
36666666663
36366666363
36636663663
36666366663
W666333666E
36666366663
36636663663
36366666363
36666666663
33333333333