33333N33333
33666666633
36366666363
36636663663
36666666663
W666666666E
36666666663
36636663663
36366666363
33666666633
33333S33333