11111N11111
14444444441
14444444441
14444444441
14444444441
W444444444E
14444444441
14444444441
14444444441
14444444441
11111111111