11111N11111
11444444411
14144444141
14414441441
14144444141
1444444444E
14144444141
14414441441
14144444141
11444444411
11111S11111