11111N11111
14444444441
14414441441
14444144441
14444444441
W4444144441
14444444441
14444144441
14414441441
14444444441
11111S11111