11111111111
14444444441
14444444441
14444444441
14444444441
W4444444441
14444444441
14444444441
14444444441
14444444441
11111S11111