11111111111
14444444441
14444444441
14444444441
11111111111
W444444444E
11114441111
14444444441
14444444441
14444444441
11111S11111