11111111111
14444444441
14444444441
14444144441
14444444441
W441414144E
14444444441
14444144441
14444444441
14444444441
11111S11111