11111N11111
14444444441
144!1444441
14411444441
14444444441
W444444444E
14444444441
14444441141
14444441441
14444444441
11111S11111