22222N22222
25555552552
25555555552
25255255552
25555555552
W555555555E
25555552552
25555525552
25255555552
25555555522
22222S22222