22222222222
25255555552
25255555552
25552555552
25552555552
W555555555E
25555525552
25555525552
25555555252
25555555252
22222S22222