11111N11111
14444444441
14444144441
14444144441
14444144441
W411111114E
14444144441
14444144441
14444144441
14444444441
11111S11111