33333N33333
36666666663
36666666663
36666666663
36666666663
W6663336663
36666666663
36663!36663
36663336663
36666666663
33333S33333