111111111111111
1!44444N44444?1
144444444444441
144444444444441
144444444444441
1W44444444444E1
144444444444441
141234444444441
144564444444441
1444444S4444441
111111111111111