33333333333
36466666463
36646464663
36664646663
36666666663
36666666663
36466466463
36466446463
36466464463
36466466463
33333333333