33333N33333
36666666663
36666366663
36666666663
36663636663
W636666636E
36663636663
36666666663
36666366663
36666666663
33333333333