22222N22222
25555555552
25222222252
25255555252
25255555252
W5255!5525E
25255555252
25255555252
25222222252
25555555552
22222S22222