22222N22222
25555555552
25552525552
25552525552
25222225552
W5552225552
25222225552
25552525552
25552525552
25555555552
22222S22222