33333N33333
36666666663
36663336663
33366366333
36666366663
W666636666E
36666366663
36666366663
33366666333
36666666663
33333333333