11111111111
14444444441
14444444441
14441114441
14444444441
W444444444E
14444444441
14441114441
14444444441
14444444441
11111S11111