22222N2222
2555555552
2555555552
2555555552
2552225552
2555555552
2222222222