##########
#...#....#
#........#
#........D
#..###...#
#........#
##########