22222N22222
25555555252
25555555252
25555555552
25555552552
W552555255E
25525555552
25555555552
25255555552
25255555552
22222S22222