1111111111
1444144441
1444444441
144444444E
1441114441
1444444441
1111111111