11111N11111
14444444441
14444444441
14414441441
14444144441
W444111444E
14444144441
14414441441
14444444441
14444444441
11111S11111