##########
#........#
#........#
D...###..D
#.....#..#
#.....#..#
#####D####