22222N22222
25555555552
25555555552
25555255552
25555255552
W552222255E
25555255552
25555255552
25555555552
25555555552
22222S22222