3333333333
3666666663
3666666663
W666666663
3666666663
36!6666663
3333333333