33333N33333
36663636663
36663636663
36663636663
36666666663
W6666666663
36663336663
33366666633
36663333663
36666666663
33333S33333